11111100000000000001
00000100111111111101
11110100100000001101
10010101100110001001
10011101111110001001
10000100000010001001
10000100000010001001
11111111000010001001
00000001000010001001
00000001111110001001
00000001001000001001
01111101001000001001
01000101111000001001
01110100101000001111
00010100101111000000
00011111100001000000
00010001100001001111
00110000000001001001
00111111111111111111
00000000000000000000