100000000000000
111000000111111
001000111110000
001011100110000
001011000010000
001001000010000
001001100010000
001011111010000
001010101010000
001110111110000
000000100000000
111111100000000
100000000000000
111100000000000
001100000000000